Bicycle: Xe đạp
Car: Ô tô
Caravan: Xe du lịch
Coach: Xe khách
High-speed train: Tàu cao tốc
Minicab: Xe taxi nhỏ
Moped: Xe máy đạp
Motorbike: Xe máy
Railway train: Tàu hỏa
Scooter: Xe tay ga
Tram: Xe điện
Truck: Xe tải
Van: Xe bán tải
Boat: Thuyền
Canoe: Xuồng
Cargo ship: Tàu chở hàng hóa
Cruise ship: Tàu du lịch
Ferry: Phà
Hovercraft: Tàu phản lực
Rowing boat: Thuyền chèo
Sailboat: Thuyền buồm
Ship: Tàu thủy
Speedboat: Tàu cứu hỏa
Helicopter: Trực thăng
Airplane/Plane: Máy bay
Propeller plane: Máy bay chạy bằng động cơ cánh quạt
Glider: Máy bay lượn
Hot-air balloon: Khinh khí cầu
Railway train: Tàu hỏa
Taxi: Xe taxi
Tube: Tàu điện ngầm (ở nước Anh)
Subway: Tàu điện ngầm
Coach: Xe khách
Underground: Tàu điện ngầm
Bus: Xe buýt
Bend: Đoạn đường gấp khúc
Bump: Đoạn đường gồ ghề
Car lane: Làn đường dành cho xe hơi
Dual carriageway: Đường hai chiều
Fork: Ngã ba đường
Highway: Đường cao tốc
Level crossing: Đường giao cắt với đường ray tàu
Motorcycle lane: Làn đường dành cho xe máy
Motorway: Đường cao tốc
Pedestrian crossing: Vạch qua đường cho người đi bộ
Railroad track: Đường ray xe lửa
Ring road: Đường vòng quanh thành phố
Road: Đường
Road narrows: Đường hẹp
Roadside: Lề đường
T-junction: Ngã ba đường hình chữ T
Toll road: Đường có trạm thu phí
Traffic jam: Tắc đường
Traffic: Giao thông
Turning: Điểm rẽ
Cross road: Đoạn đường giao nhau
Dead end: Đường cụt
End of dual carriageway: Hết làn đường kép
Handicap parking: Chỗ đỗ xe dành riêng cho người khuyết tật
Hard shoulder: Vạch đứt cạnh xa lộ cho phép dừng xe
No crossing: Cấm qua đường
No entry: Biển cấm vào
No horn: Biển cấm còi
No overtaking: Biển cấm vượt
No parking: Biển cấm đỗ xe
No U-Turn: Biển cấm vòng
Railway: Đường sắt
Road goes right: Đường rẽ phải
Road sign: Biển bảng chỉ đường
Road widens: Đường trở nên rộng hơn
Roundabout: Bùng binh
Slippery road: Đường trơn
Slow down: Yêu cầu giảm tốc độ
Speed limit: Giới hạn tốc độ
T-Junction: Ngã ba hình chữ T
Two-way traffic: Đường hai chiều
Your priority: Đoạn đường được ưu tiên
Accident: Tai nạn
Breathalyzers: Dụng cụ kiểm tra độ cồn trong hơi thở
Car park: Bãi đỗ xe
Infrastructure: Cơ sở hạ tầng
Journey: Hành trình
Junction: Giao lộ
Kerb: Mép vỉa hè
Learner driver: Người tập lái
One-way street: Đường một chiều
Parking ticket: Vé đỗ xe
Passenger: Hành khách
Petrol station: Trạm bơm xăng
Private transport: Phương tiện giao thông cá nhân
Public transport: Phương tiện giao thông công cộng
Sidewalk: Vỉa hè
Signpost: Tấm biển báo giao thông
Traffic: Giao thông (nói chung)
Traffic jam: Tắc nghẽn giao thông
Traffic light: Đèn giao thông
Traffic warden: Nhân viên kiểm soát việc đỗ xe
Transport: Vận chuyển
Transport system: Hệ thống giao thông
Transportation: Phương tiện giao thông
Trip: Chuyến đi
Vehicle: Phương tiện
Bypass: Đường vòng
Car hire: Thuê xe
Car wash: Rửa xe ô tô
Diesel: Dầu diesel
Driver: Tài xế
Driving instructor: Giáo viên dạy lái xe
Driving lesson: Buổi học lái xe
Driving licence: Bằng lái xe
Driving test: Kỳ thi lái xe
Garage: Gara
Hard shoulder: Vạt đất cứng
Jump leads: Dây nối cực pin
Kerb: Mép vỉa hè
Level crossing: Đoạn đường giao cấp
Mechanic: Thợ sửa xe
Oil: Dầu
Parking meter: Máy tính tiền đỗ xe
Parking space: Chỗ đỗ xe
Petrol: Xăng
Petrol pump: Bơm xăng
Puncture: Lốp xịt
Reverse gear: Số lùi
Second-hand: Đồ cũ
Services: Trạm dịch vụ
Speed: Tốc độ
To accelerate: Tăng tốc
To change gear: Chuyển số
To drive: Lái xe
To skid: Trượt xe
To slow down: Giảm tốc độ
To stall: Bị chết máy
To swerve: Ngoặt xe
Toll road: Đường có thu phí
Toll: Lệ phí
Traffic: Giao thông
Tyre pressure: Áp suất lốp
Cone: Cọc tiêu giao thông
Corner: Góc đường
Crossroads: Ngã tư
Crosswalk: Vạch qua đường dành cho người đi bộ
Flat tyre: Bánh xe bị sịt
Icy road: Đường băng giá
Jack: Cần gạt hạc
Lane: Làn đường
Lay-by: Vị trí tạm dừng xe
Manhole: Nắp cống
Multi-storey car park: Bãi đỗ xe nhiều tầng
Parking lot: Bãi đỗ xe
Pavement: Vỉa hè
Road map: Bản đồ đường
Roadblock: Rào chắn đường
Roadworks: Công trình sửa đường
Speed camera: Camera ghi tốc độ
Speeding fine: Tiền phạt vượt tốc độ
Spray: Bụi nước
To brake: Phanh
Tunnel: Đường hầm
Turnpike: Đường cao tốc có thu phí
Unleaded: Không chì