Bicycle: Xe đạp
Minicab: Xe cho thuê
Motorbike: Xe máy
Scooter: Xe tay ga
Tram: Xe điện
Truck: Xe tải
Car: Ô tô
Caravan: Xe lưu động
Coach: Huấn luyện viên
Van: Xe tải có kích thước nhỏ
Moped: Xe máy có bàn đạp
Bus: xe buýt
Subway: tàu điện ngầm
High-speed train: tàu cao tốc
Railway train: tàu hỏa
Coach: xe khách
Taxi: xe taxi
Tube: tàu điện ngầm
Underground: tàu điện ngầm
Helicopter: Trực thăng
Glider: Tàu lượn
Hot-air balloon: Khinh khí cầu
Airplane: Máy bay
Boat: Thuyền
Cruise ship: Tàu du lịch
Sailboat: Thuyền buồm
Ship: Tàu thủy
Speedboat: Tàu siêu tốc
Ferry: Phà
Canoe: Xuồng
Highway: Đường cao tốc 
Motorcycle lane: Đường cho xe máy
Motorway: Xa lộ
Bend: Đường gấp khúc
Bump: Đường bị xóc
Car lane: Đường cho xe hơi
Dual carriageway: Xa lộ hai chiều
Fork: Ngã ba
Pedestrian crossing: Vạch để qua đường
Railroad track: Đường ray xe lửa
Roadside: Phần đường làm lề
T-junction: Ngã ba đường
Toll road: Đường có thu phí
Turning: Điểm có thể rẽ
Ring road: Đường vành đai
Road: Đường
Road narrows: Đường hẹp
Road goes right: Đường đi bên phải
Road sign: Bảng chỉ đường  
Cross road: Đoạn đường hay giao nhau  
Dead end: Đường cuối, đường cụt
No U-Turn: Biển cấm vòng  
Railway: Các loại đường sắt
Road widens: Đường rộng hơn
Roundabout: Bùng binh vòng tròn
Slippery road: Đường trơn trượt
Slow down: Giảm tốc độ  
Speed limit: Giới hạn tốc độ
T-Junction: Ngã ba chữ T
Hard shoulder: Khu cho đỗ xe
No crossing: Biển cấm qua đường
No entry: Không được vào  
No horn: Biển cấm bấm còi  
No overtaking: Biển cấm vượt qua
No parking: Biển cấm đỗ xe  
Two way traffic: Đường đi hai chiều
Your priority: Đoạn đường ưu tiên
Kerb: Mép vỉa hè
Learner driver: Người tập lái xe
One-way street: Đường một chiều
Accident: Tai nạn
Breathalyzers: Dụng cụ đo độ cồn
Car park: Bãi đậu xe máy
Journey: Chuyến hành trình
Junction: Giao lộ  
Parking ticket: Vé giữ xe
Passenger: Hành khách
Petrol station: Chỗ đổ xăng
Trip: Chuyến đi
Vehicle: Phương tiện  
Traffic: Giao thông nói chung  
Traffic jam: Tắc nghẽn giao thông
Traffic light: Đèn giao thông  
Transport: Vận, di chuyển
Sidewalk: Vỉa hè  
Signpost: Biển báo giao thông  
Transport system: Hệ thống giao thông
Transportation: Phương tiện giao thông



